10 10
11111111111
11111111111
11222222211
11222222211
11221112211
11221112211
11222222111
11222222211
11111111111
11111111111
