5 10
1111111111
1122222211
1122112211
1122222211
1111111111
